████████████████████████████████████████████████████████████████████████████████
██                                                                            ██
██                                                                            ██
██                                                                            ██
██                                                                            ██
██                                                                            ██
██                                                                            ██
██                                                                            ██
██                                                                            ██
██                                                                            ██
██                                                                            ██
██                  ██                                                        ██
██                ██  ██                                                      ██
██                  ██                                                        ██
██                                                                            ██
██                                                                            ██
██                                                                            ██
██                                                                            ██
██                                                                            ██
██                                                                            ██
██                                                                            ██
██                                                                            ██
██                                                                            ██
██                                                                            ██
██                                                                            ██
██                                                                            ██
██                                                                            ██
██                                                                            ██
██                                                                            ██
██                                                                            ██
██                                                                            ██
██                                                                            ██
██                                                                            ██
██                                                                            ██
██                                                                            ██
██                                                                            ██
██                                                                            ██
██                                                                            ██
██                                                                            ██
██                                                                            ██
████████████████████████████████████████████████████████████████████████████████